W,W,W,W,W,W,W,W,W,W,W,W,W,W,W
W,W,W,W,W,W,W,W,W,W,W,W,W,W,W
W,W,W,W,W,W,T,T,T,W,W,W,W,W,W
W,W,W,W,W,W,T,S,T,W,W,W,W,W,W
W,W,W,W,W,W,W,W,W,W,W,W,W,W,W
W,W,W,W,W,W,W,W,W,W,W,W,W,W,W
W,W,W,W,W,W,W,E,W,W,W,W,W,W,W
W{LR},W{LR},W{LR},W{LR},W{LR},W{LR},R{LR},R{LUR},R{LR},W{LR},W{LR},W{LR},W{LR},W{LR},W{LR}
R,R,R,R,R,R,R,R,R,R,R,R,R,R,R
