W,W,W,W{RD},W{LR},W{LR},W{LR},W{LR},W{LR},W{LD},W,W,W,W,W
W{RD},W{LR},W{LD},W{UD},W,W{RD},R{LR},R{LD},R,W{UD},W{RD},W{LR},W{LR},W{LD},W
W{UD},W,W{UD},W{UD},W,R{UD},T,E,T,R{UD},W{UD},W,W,W{UD},W
W{UD},W,W{UD},W{UD},W,R{UD},T,T,T,R{UD},W{UD},W,W,W{UD},W
W{LUR},W{LRD},W{LUR},W{LUR},W{LRD},R{LUD},T,!,T,R{URD},W{LUR},W{LRD},W{LRD},W{LUR},W{LRD}
W,W{UD},W,W,W{UD},R{UD},T,T,T,R{UD},W,W{UD},W{UD},W,W{UD}
W,W{UD},W,W,W{UD},R{UD},T,S,T,R{UD},W,W{UD},W{UD},W,W{UD}
W,W{UR},W{LR},W{LR},W{LU},W{UD},R,R{UR},R{LR},W{LU},W,W{UD},W{UR},W{LR},W{LU}
W,W,W,W,W,W{UR},W{LR},W{LR},W{LR},W{LR},W{LR},W{LU},W,W,W
