W,W,W,W,W,W,W,W,W,W,W,W,W,W,W
W,W,W,W,W,W,R,R,R,W,W,W,W,W,W
W,W,W,W,W,R,T,E,T,R,W,W,W,W,W
W,W,W,W,W,R,T,T,T,R,W,W,W,W,W
W,W,W,W,W,R,T,T,T,R,W,W,W,W,W
W,W,W,W,W,R,T,T,T,R,W,W,W,W,W
W,W,W,W,W,R,T,S,T,R,W,W,W,W,W
W,W,W,W,W,W,R,R,R,W,W,W,W,W,W
W,W,W,W,W,W,W,W,W,W,W,W,W,W,W
